%%%%%%%%%%%%%%%%%%%%%%
% %% .      % %      %
%    %%%%%% % %%%%%%.%
%%%%%%     P  %  .   %
%    % %%%%%% %% %%%%%
% %%%% %   .     %   %
% .      %%% %%% . % %
%%%%%%%%%%    %%%%%% %
%.         %%    .   %
%%%%%%%%%%%%%%%%%%%%%%