%%%%%%%%%%%%%%%%%%%%%%
% %%        % %      %
%    %%%%%% % %%%%%%.%
%%%%%%     P  %      %
%    % %%%%%% %% %%%%%
% %%%% %         %   %
% .      %%% %%%   % %
%%%%%%%%%%    %%%%%% %
%.         %%        %
%%%%%%%%%%%%%%%%%%%%%%